Var	Lab
Meanspeed	MnSp
Rotations	Rot
Center	Ctr
Alternations	Alt
Choices	Chc
Activity	Act
Nocturnal	Noc
PlacePref	PcP
SerialLearn	SrL
ReversalLearn	RvL
SucPref	ScP
Baseline	PpiBs
inhibition70	Ppi70
inhibition75	Ppi75
inhibition80	Ppi80
Timeimmobile	TmIm
FreezeBase	FrBs
Context	Con
Cue	Cue
SpontaneousAlternations	Alt
Conditioning	FrBs
AchievedReversals	SrL
Remote	Rem